1111111111111
1P0100C0C00C1
1000011111001
1C0011E000001
1111111111111